2	2	2	2	2	2	2	2	2	2	2	2	2	2	2	2	2	2	2	2	2	2	2	2	2	2	2	2	2	2	2	1
11	11	11	11	13	12	14	13	12	14	13	12	14	13	12	14	13	12	14	13	12	14	13	12	14	13	12	14	13	12	14	3
24	24	24	24	24	24	24	24	24	24	24	24	24	24	24	24	24	24	24	24	24	24	24	24	24	24	24	24	24	24	24	3
3	24	25	25	25	25	25	25	25	25	25	25	26	26	26	28	29	26	26	26	25	25	25	25	25	25	25	25	25	25	24	3
3	24	25	24	24	24	24	24	24	24	24	24	26	24	24	30	31	24	24	26	24	24	24	24	24	24	24	24	24	25	24	3
3	24	25	24	25	25	25	25	25	25	25	25	26	25	25	32	33	25	25	26	25	25	25	25	25	25	25	25	24	25	24	3
3	24	25	24	25	26	26	26	26	26	26	26	26	24	24	24	24	24	24	26	26	26	26	26	26	26	26	25	24	25	24	3
3	24	25	24	25	26	34	34	34	34	34	34	34	34	34	34	34	34	34	34	34	34	34	34	34	34	26	25	24	25	24	3
3	24	25	24	25	26	34	34	34	34	34	34	34	34	34	34	34	34	34	34	34	34	34	34	34	34	26	25	24	25	24	3
3	24	25	24	25	26	34	34	34	34	34	34	34	34	34	34	34	34	34	34	34	34	34	34	34	34	26	25	24	25	24	3
3	24	25	24	25	26	34	34	34	34	34	34	34	34	34	34	34	34	34	34	34	34	34	34	34	34	26	25	24	25	24	3
3	24	25	24	25	26	34	34	34	34	34	34	34	34	34	34	34	34	34	34	34	34	34	34	34	34	26	25	24	25	24	3
3	24	25	24	25	26	34	34	34	34	34	34	34	34	34	34	34	34	34	34	34	34	34	34	34	34	26	25	24	25	24	3
3	24	25	24	25	26	34	34	34	34	34	34	34	34	34	34	34	34	34	34	34	34	34	34	34	34	26	25	24	25	24	3
3	24	25	24	25	26	34	34	34	34	34	34	34	34	34	34	34	34	34	34	34	34	34	34	34	34	26	25	24	25	24	3
3	24	25	24	25	26	34	34	34	34	34	34	34	34	34	34	34	34	34	34	34	34	34	34	34	34	26	25	24	25	24	3
3	24	25	24	25	26	34	34	34	34	34	34	34	34	34	34	34	34	34	34	34	34	34	34	34	34	26	25	24	25	24	3
3	24	25	24	25	26	34	34	34	34	34	34	34	34	34	34	34	34	34	34	34	34	34	34	34	34	26	25	24	25	24	3
3	24	25	24	25	26	34	34	34	34	34	34	34	34	34	34	34	34	34	34	34	34	34	34	34	34	26	25	24	25	24	3
3	24	25	24	25	26	26	26	26	26	26	26	26	26	26	26	26	26	26	26	26	26	26	26	26	26	26	25	24	25	24	3
3	24	25	24	24	24	24	24	24	24	24	24	24	24	24	24	24	24	24	24	24	24	24	24	24	24	24	24	24	25	24	3
3	24	25	25	25	25	25	25	25	25	25	25	25	25	25	25	25	25	25	25	25	25	25	25	25	25	25	25	25	25	24	3
3	24	24	24	24	24	24	24	24	24	24	24	24	24	24	24	24	24	24	24	24	24	24	24	24	24	24	24	24	24	24	3
4	2	2	2	2	2	2	2	2	2	2	2	2	2	2	2	2	2	2	2	2	2	2	2	2	2	2	2	2	2	2	5