2	2	19	2	19	2	19	2	2	19	19	2	19	2	2	10	2	2	19	19	2	19	2	2	10	2	19	2	19	19	2	1
11	11	11	11	11	11	11	11	11	11	11	11	11	11	11	3	11	11	11	11	11	11	11	11	3	11	11	11	11	11	11	3
26	24	24	24	26	25	26	24	25	25	26	24	24	24	24	3	25	26	25	25	26	25	24	24	3	25	26	24	24	26	22	3
0	2	2	2	7	27	0	19	19	7	25	6	2	1	24	18	25	0	2	19	19	2	19	19	9	2	19	1	25	0	19	16
3	11	11	11	11	26	3	13	12	14	27	11	11	3	27	11	24	3	13	12	14	15	11	15	11	11	11	18	26	3	12	3
3	25	24	24	26	24	3	24	26	25	25	26	26	3	25	25	25	3	24	25	26	25	26	24	26	26	26	11	27	3	26	3
3	24	0	19	1	26	4	2	10	19	2	7	24	4	2	19	19	5	25	6	10	19	2	19	2	7	26	24	26	3	25  3
3	26	3	12	3	26	11	11	3	15	11	11	24	11	11	15	11	11	27	11	3	11	11	13	12	14	25	17	25	3	26	3
3	25	3	22	3	26	25	25	3	24	26	25	24	26	24	26	26	24	26	25	3	22	26	24	26	25	26	4	2	5	25  3
3	25	18	26	4	2	1	25	4	19	10	2	2	19	1	27	0	2	1	24	8	19	10	19	7	20	21	11	11	11	26	3
3	26	11	27	11	15	3	26	11	11	3	13	12	14	3	25	3	12	3	22	3	11	3	11	11	24	24	25	25	25	24	3
3	24	24	26	25	24	3	24	24	26	3	25	26	25	3	25	3	26	4	19	5	26	18	26	25	24	0	2	2	2	2	16
8	19	19	2	1	25	4	2	1	26	3	25	17	26	3	25	3	25	11	15	11	26	11	24	17	24	3	13	12	14	11	3
3	15	11	15	3	25	11	11	3	25	3	26	3	24	3	22	3	25	24	24	24	24	24	25	3	25	3	25	24	25	25	3
3	25	25	22	3	24	26	26	3	24	3	25	3	25	4	19	5	25	0	2	19	2	19	2	9	2	9	19	2	1	24	3
3	24	6	2	9	2	1	26	3	24	4	2	16	24	11	15	11	27	3	11	15	11	13	12	14	11	15	11	15	3	24	3
3	25	15	13	12	14	3	25	3	26	15	11	3	26	25	24	25	24	3	25	26	26	24	24	26	24	24	25	24	3	25	3
3	25	25	24	26	24	3	25	3	26	24	25	8	19	2	2	10	19	5	25	0	2	19	2	10	2	19	7	25	3	24	3
3	25	0	19	1	25	3	25	8	19	1	25	3	13	12	14	3	11	15	27	3	15	11	11	3	13	12	14	24	3	26	3
3	25	3	12	3	27	3	26	3	15	3	25	3	26	25	26	3	25	25	25	3	26	25	25	3	24	24	26	25	3	26	3
3	24	18	24	3	25	18	25	18	22	3	24	18	26	17	26	18	26	6	19	9	19	7	24	3	25	6	19	2	5	24	18
3	24	11	26	3	26	11	24	11	24	3	27	11	25	3	25	11	24	12	14	15	11	15	26	3	26	15	11	15	11	24	11
3	25	24	25	3	26	26	26	24	24	3	25	26	26	3	24	26	24	25	24	24	25	25	24	3	24	24	25	24	27	25	35
4	19	2	2	9	19	2	19	2	19	9	2	19	2	9	19	2	2	19	2	2	19	19	19	9	2	2	19	19	19	2	2